NO ./textures/brick-texture-png-23885.png
SO ./textures/brick-texture-png-23868.png
WE ./textures/brick-texture-png-23873.png
EA ./textures/brick-texture-png-23887.png

C 115,215,225
F 74,160,44

111111111111111111111111111111111111111111111111111111111111111111111111111111111111111111111
100000000000000000000000000000000000000000000000000000000000000000000000000000000000000000001
101010101010101010101010101010101010101010101010101010101010101010101010101010101010101010101
100000000000000000000000000000000000000000000000000000000000000000000000000000000000000000001
101010101010101010101010101010101010101010101010101010101010101010101010101010101010101010101
100000000000000000000000000000000000000000000000000000000000000000000000000000000000000000001
101010101010101010101010101010101010101010101010101010101010101010101010101010101010101010101
100000000000000000000000000000000000000000000000000000000000000000000000000000000000000000001
101010101010101010101010101010101010101010101010101010101010101010101010101010101010101010101
100000000000000000000000000000000000000000000000000000000000000000000000000000000000000000001
101010101010101010101010101010101010101010101010101010101010101010101010101010101010101010101
100000000000000000000000000000000000000000000000000000000000000000000000000000000000000000001
101010101010101010101010101010101010101010101010101010101010101010101010101010101010101010101
100000000000000000000000000000000000000000000000000000000000000000000000000000000000000000001
101010101010101010101010101010101010101010101010101010101010101010101010101010101010101010101
100000000000000000000000000000000000000000000000000000000000000000000000000000000000000000001
101010101010101010101010101010101010101010101010101010101010101010101010101010101010101010101
100000000000000000000000000000000000000000000000000000000000000000000000000000000000000000001
101010101010101010101010101010101010101010101010101010101010101010101010101010101010101010101
100000000000000000000000000000000000000000000000000000000000000000000000000000000000000000001
101010101010101010101010101010101010101010101010101010101010101010101010101010101010101010101
100000000000000000000000000000000000000000000000000000000000000000000000000000000000000000001
101010101010101010101010101010101010101010101010101010101010101010101010101010101010101010101
100000000000000000000000000000000000000000000000000000000000000000000000000000000000000000001
101010101010101010101010101010101010101010101010101010101010101010101010101010101010101010101
100000000000000000000000000000000000000000000000000000000000000000000000000000000000000000001
101010101010101010101010101010101010101010101010101010101010101010101010101010101010101010101
100000000000000000000000000000000000000000000000000000000000000000000000000000000000000000001
101010101010101010101010101010101010101010101010101010101010101010101010101010101010101010101
100000000000000000000000000000000000000000000000000000000000000000000000000000000000000000001
101010101010101010101010101010101010101010101010101010101010101010101010101010101010101010101
10000000000000000000000000000000000000000000N000000000000000000000000000000000000000000000001
101010101010101010101010101010101010101010101010101010101010101010101010101010101010101010101
100000000000000000000000000000000000000000000000000000000000000000000000000000000000000000001
101010101010101010101010101010101010101010101010101010101010101010101010101010101010101010101
100000000000000000000000000000000000000000000000000000000000000000000000000000000000000000001
101010101010101010101010101010101010101010101010101010101010101010101010101010101010101010101
100000000000000000000000000000000000000000000000000000000000000000000000000000000000000000001
101010101010101010101010101010101010101010101010101010101010101010101010101010101010101010101
100000000000000000000000000000000000000000000000000000000000000000000000000000000000000000001
101010101010101010101010101010101010101010101010101010101010101010101010101010101010101010101
100000000000000000000000000000000000000000000000000000000000000000000000000000000000000000001
101010101010101010101010101010101010101010101010101010101010101010101010101010101010101010101
100000000000000000000000000000000000000000000000000000000000000000000000000000000000000000001
101010101010101010101010101010101010101010101010101010101010101010101010101010101010101010101
100000000000000000000000000000000000000000000000000000000000000000000000000000000000000000001
101010101010101010101010101010101010101010101010101010101010101010101010101010101010101010101
100000000000000000000000000000000000000000000000000000000000000000000000000000000000000000001
101010101010101010101010101010101010101010101010101010101010101010101010101010101010101010101
100000000000000000000000000000000000000000000000000000000000000000000000000000000000000000001
111111111111111111111111111111111111111111111111111111111111111111111111111111111111111111111
